0 0 0 0 0 0 0 0 0 0 0 0 0 0 0 0 0 0 0 0 0 0 0 0
0 1 1 2 3 2 3 2 3 2 3 2 3 2 3 0 0 0 0 0 0 0 0 0 
0 1 1 3 2 3 2 3 2 3 2 3 2 3 2 0 0 0 0 0 0 0 0 0
0 0 0 2 3 2 3 2 3 2 3 2 3 2 3 0 0 0 0 0 0 0 0 0
0 0 0 0 0 0 0 0 0 3 2 3 2 3 2 0 0 0 0 0 0 0 0 0 
0 0 0 0 0 0 0 0 0 2 3 2 3 2 3 0 0 0 0 0 0 0 0 0
0 0 0 0 0 0 0 0 0 3 2 3 2 3 2 0 0 0 0 0 0 0 0 0
0 0 0 0 0 0 0 0 0 2 3 2 3 2 3 0 0 0 0 0 0 0 0 0
0 0 0 0 0 0 0 0 0 3 2 3 2 3 2 0 0 0 0 0 0 0 0 0
0 0 0 0 0 0 0 0 0 2 3 2 3 2 3 0 0 0 0 0 0 0 0 0
0 0 0 0 0 0 0 0 0 3 2 3 2 3 2 0 0 0 0 0 0 0 0 0
0 0 0 0 0 0 0 0 0 2 3 2 3 2 3 2 3 2 3 2 3 0 0 0
0 0 0 0 0 0 0 0 0 3 2 3 2 3 2 3 2 3 2 3 2 4 4 0
0 0 0 0 0 0 0 0 0 2 3 2 3 2 3 2 3 2 3 2 3 4 4 0
0 0 0 0 0 0 0 0 0 0 0 0 0 0 0 0 0 0 0 0 0 0 0 0
0 0 0 0 0 0 0 0 0 0 0 0 0 0 0 0 0 0 0 0 0 0 0 0